english vocabulary by Vetal, Olga and joker, last edited 10/29/2020 @11:05 PM
список несортированный, так что ищите нужные слова через Ctrl + F 

{
multifarious differences - разнообразные отличия
disparate mixture - разрозненная смесь
British Commonwealth - Британское Содружество
miscellaneous - разнообразное (из разных источников)
the social ladder - социальная лестница
unbridled - необузданный
drop by - зайти (в гости)
pushy - наглый, чрезмерно напористый
to sneak a look at - мельком взгянуть (воровато взглянуть)
fighting fit - в хорошей физической форме 
elicits a response - вызывать ответ 
raining cats and dogs - льёт как из ведра (сильный дождь)
pouring rain  - льёт как из ведра (сильный дождь)
bucketing rain - льёт как из ведра (сильный дождь)
hallowed topic - священная тема
awful hash - страшная мешанина, путаница
endman - последний человек в очереди
huddle together - собиратся вместе, в группу
belligerent - яростный, воинственный
feign sleep - делать вид, что спишь
out of step - несинхроннизированый, (идти) не в ногу
} 

{
sway - иметь влияние (над чем-то/кем-то)
underpin - подкреплять (to give support, strength, or a basic structure to something)
splendid isolation - великолепная изоляция
devour - пожирать, поглощать (про еду или территории)
omnipresence - вездесущность (the fact of being present or having an effect everywhere at the same time)
marginalize - маргинализировать, не придавать особого значения (to threat someone as if they are not important)
scathing - жестокий, злой, едкий (criticizing someone in a severe and unkind way)
estuary - устье (реки)
in a fit of absence of mind - в припадке отсутствия ума;
indoctrinate - внушать
fierce hostility - яростная враждебность
libels - клевета
unveil - раскрывать, представлять (на всеобщее обозрение)
press-only - только для прессы
protective hull - защитный корпус/каркас
heat sink - радиатор
off the charts - из ряда вон
keynote presentation - основной доклад
lineup - очередь, линейка (линейка автомобилей/смартфонов)
tweak - подправить, настроить
exceedingly - чрезвычайно, восхитительно
carrier - оператор связи
acting up - барахлить, работать с перебоями
groping around (to grope around) - бродить в поисках чего-то, нащупывать что-то
distress call - сигнал бедствия
legacy - наследие
prudence - благоразумие, осмотрительность;
relay - передать, доставлять
quaint - причудливый
intelligence - разведка (в соответствующем контексте)
ubiquity - повсеместность, синоним к "вездесущность"
grinning - ухмыляющийся
flattering - лестный
dispiriting - удручающий
adhere - примыкать (к движению), адаптировать (новые тренды)
conventional - общепринятый
bulging eyes - выпученные глаза
car boot sale - блошиный рынок, распродажа
}

{
set aside - откладывать (деньги), откладывать в сторону
turn out {to be} - оказаться 
count on - рассчитывать на
sign up - записаться (в добровольцы), согласится делать что-либо 
line up - выстроиться в очередь
work on - работать над (чем-то), также применяется к людям в значениях "повлиять", "заставить"
be crazy about - сходить с ума от чего-то
{become} obsessed - {стать} одержимый{м}
give a try - попробовать что-то
get a taste - войти во вкус (пример - "He got a taste of paintballing after the first match." - "После своего первого матча в пейнтболле он вошёл во вкус")
passion - страсть, увлечение
get the {something} bug - "заболеть" чем-то (стать фанатом чего-то)
afficionado - поклонник
keen on - повёрнут на чём-то
take up - начать (заниматся спортом/т.п.)
be into something - быть увлечённым чем-то
}

{
intetionally-unattractive {selfies} - умышленно непривлекательные селфи
clown around like muppets - дурачится, вести себя глупо и легкомысленно
die for - буквально "умереть за", приложить все силы
get at - понять 
coming up - приближатся (про какое-либо событие)
coming on - продолжатся, прогрессировать
ask for {trouble} - напрашиватся на {неприятности}
be weighed down - нести тяжёлый груз (эмоциональный), быть угнетённым чем-либо
be bowled over - быть сбитым (с толку), перебитым (про разговор)
swept up - унесённый (эмоциями), под сильным  влиянием
frown upon - нахмуриться, надуться
hush up - скрыть, умолчать о чём-либо  
}

{
pagan roots - языческие корни 
christian roots - христианские корни
departed souls - души умерших, отбывшие {в мир иной} души
jack'o'lantern - фонарь Джека (свеча в тыкве), хеллоуинская тыква
guisers - буквально "обманщики" / те, кто празднуют Хеллоуин
to etch - вырезать, гравировать 
turnip - репа
poke fun at Satan - прикалыватся над Сатаной
abstinence from meat - воздержание от мяса
taffy - ирис
rumors - слухи
rampant - безудержный
to wane in the wake of - (про событие или традицию) исчезать после какого-либо события
heinous practice - гнусное занятие 
tampering - вмешательство 
}
{
quintessential - квинтэссенция
latecomer - опоздавший/поздно пришедший
shores - берега
beverage - напиток
curiously - любопытно
touting - рекламировать	
virtues - добродетели
lusty - похотливый/страстный
revenue - доход
sedition - подстрекательство/ призыв к бунту	
smuggling - контрабанда
precious cargo - ценный груз
vessels - судна (шлюпки)
parish - прихожане/церковный приход
adulternate - взрослый
willow - ива
licorice - лакрица
sloe leaves - терновые листья
tall-masted vessels - мачтовые шлюпки
hefty bonus - большой бонус
tea run - чайная церемония
remarkable - узнаваемый/замечательный
launched - запустить
fireworks - фейерверки
capped - закрытый
unchaperoned - без присмотра
tremendous growth - огромный рост 
}